1111111111111
10010000000C1
1000010111001
100011E100001
1P0011C100001
1111111111011
