11111111111111111111111111111111111111111111111111111111111111111111111
10010C00000C0010C00000010000001110010010C00000C0010C0000001000000111001
10010C00000C0010C00000010000001110010010C00000C0000C0000000000000111001
100000011100110C000000010000001110000000C00000C0000C0000001000000000001
1P0010E0000C110000000100110C000000010010C00000C0010C0000001000000111001
10010C00000C0000001001000000000000010010C00000C0010C0000001000000111001
11111111111111111111111111111111111111111111111111111111111111111111111
